countries,totalgames,total_wins,total_loses,total_x,friendly_wins,friendly_loses,friendly_x,no_friendly_wins,no_friendly_loses,no_friendly_x,totalgames_2015_2021,total_wins_2015_2021,total_loses_2015_2021,total_x_2015_2021,total_goals_scored,total_goals_scored_in,total_goals_scored_2015_2021,total_goals_scored_in_2015_2021,category

Scotland,790,375,246,169,102,84,45,273,162,124,53,24,20,9,1364,972,79,67,Team_with_Fifa_Rank( 1--89)

England,1020,580,197,243,227,90,98,353,107,145,72,45,13,14,2230,999,146,53,Team_with_Fifa_Rank( 1--89)

Wales,667,215,309,143,49,73,34,166,236,109,58,28,17,13,832,1087,69,49,Team_with_Fifa_Rank( 1--89)

Northern Ireland,654,166,338,150,30,55,34,136,283,116,59,22,23,14,680,1233,62,62,Team_with_Fifa_Rank( 1--89)

United States,691,299,247,145,130,147,86,169,100,59,83,45,22,16,1020,918,166,84,Team_with_Fifa_Rank( 1--89)

Canada,383,136,160,87,61,98,39,75,62,48,42,22,13,7,457,526,96,45,Team_with_Fifa_Rank( 1--89)

Uruguay,891,386,288,217,123,110,82,263,178,135,59,28,19,12,1404,1119,91,63,Team_with_Fifa_Rank( 1--89)

Argentina,987,529,213,245,188,79,104,341,134,141,66,35,12,19,1837,1035,117,60,Team_with_Fifa_Rank( 1--89)

Austria,800,334,292,174,182,178,106,152,114,68,60,33,16,11,1426,1252,95,61,Team_with_Fifa_Rank( 1--89)

Hungary,943,442,294,207,264,171,130,178,123,77,58,23,22,13,1920,1407,77,73,Team_with_Fifa_Rank( 1--89)

Czechoslovakia,497,223,161,113,120,100,64,103,61,49,0,0,0,0,917,690,0,0,Team_with_Fifa_Rank( 180--269)

Belgium,779,341,272,166,167,180,99,174,92,67,72,55,8,9,1387,1204,205,62,Team_with_Fifa_Rank( 1--89)

France,851,425,246,180,215,173,100,210,73,80,78,55,11,12,1516,1109,158,69,Team_with_Fifa_Rank( 1--89)

Switzerland,808,284,348,176,151,214,92,133,134,84,66,36,16,14,1182,1354,122,62,Team_with_Fifa_Rank( 1--89)

Netherlands,796,404,212,180,193,143,116,211,69,64,62,33,17,12,1640,981,121,67,Team_with_Fifa_Rank( 1--89)

Germany,961,560,203,198,303,149,120,257,54,78,74,42,15,17,2144,1117,163,78,Team_with_Fifa_Rank( 1--89)

Sweden,1030,506,299,225,244,175,125,262,124,100,78,36,24,18,2030,1321,115,74,Team_with_Fifa_Rank( 1--89)

Norway,814,298,331,185,139,160,92,159,171,93,57,26,19,12,1226,1346,84,65,Team_with_Fifa_Rank( 1--89)

Italy,812,431,154,227,190,87,111,241,67,116,68,40,10,18,1393,782,129,49,Team_with_Fifa_Rank( 1--89)

Chile,769,294,313,162,126,119,69,168,194,93,72,31,23,18,1098,1110,110,87,Team_with_Fifa_Rank( 1--89)

Finland,756,196,404,156,91,165,72,105,239,84,64,26,26,12,892,1579,69,72,Team_with_Fifa_Rank( 1--89)

Luxembourg,413,38,323,52,18,101,29,20,222,23,59,15,35,9,254,1110,52,107,Team_with_Fifa_Rank( 90--179)

Catalonia,47,18,17,12,18,17,12,0,0,0,2,0,1,1,73,83,3,4,Team_with_Fifa_Rank( 180--269)

Russia,705,360,160,185,155,82,111,205,78,74,69,30,24,15,1215,686,125,90,Team_with_Fifa_Rank( 1--89)

Denmark,806,364,270,172,148,132,71,216,138,101,65,32,11,22,1444,1110,120,49,Team_with_Fifa_Rank( 1--89)

Brazil,990,631,158,201,294,55,83,337,103,118,69,48,6,15,2170,900,143,33,Team_with_Fifa_Rank( 1--89)

Basque Country,57,37,9,11,37,9,11,0,0,0,5,3,0,2,154,75,9,4,Team_with_Fifa_Rank( 180--269)

Japan,633,306,184,143,106,87,50,200,97,93,79,46,18,15,1124,723,171,71,Team_with_Fifa_Rank( 1--89)

Philippines,232,65,128,39,23,39,11,42,89,28,47,15,20,12,275,506,58,77,Team_with_Fifa_Rank( 90--179)

Paraguay,722,257,273,192,94,90,75,163,183,117,53,12,23,18,950,1038,54,79,Team_with_Fifa_Rank( 180--269)

Estonia,488,120,260,108,77,120,66,43,140,42,72,19,36,17,487,870,66,115,Team_with_Fifa_Rank( 90--179)

Provence,17,4,12,1,0,2,0,4,10,1,0,0,0,0,38,51,0,0,Team_with_Fifa_Rank( 180--269)

Costa Rica,610,258,197,155,70,92,62,188,105,93,71,23,30,18,988,716,79,87,Team_with_Fifa_Rank( 1--89)

El Salvador,504,168,225,111,52,109,56,116,116,55,47,21,17,9,616,743,51,58,Team_with_Fifa_Rank( 1--89)

Guatemala,448,159,176,113,64,94,50,95,82,63,33,15,12,6,614,609,56,45,Team_with_Fifa_Rank( 90--179)

Yugoslavia,481,223,160,98,105,100,56,118,60,42,0,0,0,0,940,740,0,0,Team_with_Fifa_Rank( 180--269)

Poland,827,356,262,209,216,172,141,140,90,68,65,33,15,17,1391,1110,119,66,Team_with_Fifa_Rank( 1--89)

Spain,705,411,131,163,178,69,90,233,62,73,69,44,7,18,1420,633,165,50,Team_with_Fifa_Rank( 1--89)

Portugal,624,303,174,147,110,99,66,193,75,81,78,48,11,19,1057,718,162,58,Team_with_Fifa_Rank( 1--89)

Brittany,12,6,3,3,6,3,3,0,0,0,0,0,0,0,18,15,0,0,Team_with_Fifa_Rank( 180--269)

Romania,704,309,214,181,134,116,91,175,98,90,59,24,16,19,1153,905,87,68,Team_with_Fifa_Rank( 1--89)

New Zealand,362,146,151,65,68,101,36,78,50,29,29,11,13,5,619,570,34,30,Team_with_Fifa_Rank( 90--179)

Australia,517,257,148,112,114,92,57,143,56,55,58,31,13,14,1046,571,118,53,Team_with_Fifa_Rank( 1--89)



Galicia,9,4,2,3,4,2,3,0,0,0,1,0,0,1,18,13,1,1,Team_with_Fifa_Rank( 180--269)

Central Spain,2,1,1,0,1,1,0,0,0,0,0,0,0,0,2,4,0,0,Team_with_Fifa_Rank( 180--269)

Mexico,876,444,231,201,209,127,105,235,104,96,93,55,20,18,1525,941,159,101,Team_with_Fifa_Rank( 1--89)

Andalusia,13,8,1,4,8,1,4,0,0,0,0,0,0,0,25,14,0,0,Team_with_Fifa_Rank( 180--269)

Asturias,1,1,0,0,1,0,0,0,0,0,0,0,0,0,3,1,0,0,Team_with_Fifa_Rank( 180--269)

China PR,596,287,174,135,131,93,67,156,81,68,64,27,21,16,1079,654,106,68,Team_with_Fifa_Rank( 1--89)

Lithuania,378,104,203,71,38,88,30,66,115,41,57,9,38,10,395,683,35,116,Team_with_Fifa_Rank( 90--179)

Turkey,579,224,212,143,108,90,80,116,122,63,68,32,14,22,778,808,101,68,Team_with_Fifa_Rank( 1--89)

Aruba,122,21,74,27,10,27,16,11,47,11,17,2,13,2,154,299,14,40,Team_with_Fifa_Rank( 180--269)

Curaçao,334,124,123,87,60,33,32,64,90,55,40,19,11,10,534,536,75,35,Team_with_Fifa_Rank( 1--89)

Bulgaria,682,251,261,170,112,128,94,139,133,76,50,15,25,10,957,1010,47,81,Team_with_Fifa_Rank( 1--89)

Egypt,636,311,167,158,140,91,78,171,76,80,59,33,14,12,1027,642,86,40,Team_with_Fifa_Rank( 1--89)

South Africa,404,175,113,116,78,55,44,97,58,72,72,27,18,27,535,405,88,67,Team_with_Fifa_Rank( 1--89)

Haiti,450,187,161,102,70,84,53,117,77,49,39,16,16,7,707,600,61,56,Team_with_Fifa_Rank( 1--89)

Jamaica,567,222,216,129,105,123,71,117,93,58,57,25,21,11,760,754,84,69,Team_with_Fifa_Rank( 1--89)

Republic of Ireland,576,220,191,165,99,92,63,121,99,102,62,19,19,24,783,708,62,61,Team_with_Fifa_Rank( 1--89)

Kenya,650,247,242,161,121,109,78,126,133,83,62,22,16,24,908,884,62,57,Team_with_Fifa_Rank( 180--269)

Uganda,626,266,191,169,103,84,81,163,107,88,79,30,21,28,965,729,78,51,Team_with_Fifa_Rank( 1--89)

Bolivia,466,103,250,113,37,73,42,66,177,71,53,10,32,11,484,907,50,107,Team_with_Fifa_Rank( 1--89)

Peru,631,201,277,153,85,106,62,116,171,91,66,26,25,15,774,911,80,75,Team_with_Fifa_Rank( 1--89)

Honduras,519,210,170,139,76,71,69,134,99,70,63,22,22,19,762,638,78,80,Team_with_Fifa_Rank( 1--89)

Guyana,266,82,130,54,43,76,32,39,54,22,25,10,11,4,338,461,50,38,Team_with_Fifa_Rank( 90--179)

Trinidad and Tobago,669,291,239,139,148,126,83,143,113,56,53,11,32,10,1140,879,66,96,Team_with_Fifa_Rank( 90--179)

Belarus,261,80,116,65,40,40,36,40,76,29,59,19,27,13,313,384,58,90,Team_with_Fifa_Rank( 1--89)

Ukraine,279,125,75,79,51,32,34,74,43,45,62,30,16,16,386,282,83,67,Team_with_Fifa_Rank( 1--89)

Barbados,265,89,117,59,42,57,33,47,60,26,37,12,19,6,345,428,44,52,Team_with_Fifa_Rank( 90--179)

Nicaragua,159,28,116,15,9,30,10,19,86,5,43,13,23,7,144,445,57,63,Team_with_Fifa_Rank( 90--179)

Greece,575,213,217,145,83,99,76,130,118,69,58,22,20,16,709,796,63,59,Team_with_Fifa_Rank( 1--89)

Martinique,304,139,87,78,65,38,39,74,49,39,28,13,9,6,561,384,46,31,Team_with_Fifa_Rank( 180--269)

Dominica,184,43,103,38,14,22,3,29,81,35,22,6,11,5,213,378,27,35,Team_with_Fifa_Rank( 90--179)

Silesia,8,3,3,2,3,3,2,0,0,0,0,0,0,0,24,17,0,0,Team_with_Fifa_Rank( 180--269)

Cuba,339,115,143,81,27,51,36,88,92,45,37,9,23,5,443,511,35,86,Team_with_Fifa_Rank( 90--179)

Guadeloupe,236,97,95,44,36,45,20,61,50,24,18,6,8,4,397,350,31,27,Team_with_Fifa_Rank( 180--269)

Israel,437,152,179,106,69,91,52,83,88,54,46,14,25,7,633,638,61,72,Team_with_Fifa_Rank( 1--89)

Indonesia,554,208,241,105,60,71,29,148,170,76,39,14,17,8,921,931,58,67,Team_with_Fifa_Rank( 90--179)

Suriname,350,155,114,81,80,49,35,75,65,46,24,14,7,3,682,500,51,25,Team_with_Fifa_Rank( 90--179)

French Guiana,157,46,79,32,12,35,9,34,44,23,27,12,11,4,233,278,44,36,Team_with_Fifa_Rank( 180--269)

Saint Lucia,199,66,103,30,13,33,7,53,70,23,15,4,7,4,286,381,13,20,Team_with_Fifa_Rank( 90--179)

Ecuador,520,157,236,127,83,78,68,74,158,59,55,24,21,10,639,847,91,74,Team_with_Fifa_Rank( 1--89)

Colombia,555,215,188,152,94,67,69,121,121,83,65,31,15,19,680,659,90,58,Team_with_Fifa_Rank( 1--89)

Venezuela,386,94,206,86,60,67,45,34,139,41,55,15,23,17,394,748,62,78,Team_with_Fifa_Rank( 1--89)

Saint Kitts and Nevis,181,73,74,34,21,24,8,52,50,26,31,14,12,5,316,278,45,38,Team_with_Fifa_Rank( 90--179)

Grenada,214,77,91,46,14,30,15,63,61,31,30,12,14,4,372,386,38,60,Team_with_Fifa_Rank( 90--179)

India,406,140,175,91,39,56,28,101,119,63,53,24,18,11,563,696,84,66,Team_with_Fifa_Rank( 90--179)

Panama,435,136,192,107,62,86,52,74,106,55,73,22,32,19,497,675,73,106,Team_with_Fifa_Rank( 1--89)

Slovakia,300,121,108,71,46,47,38,75,61,33,60,27,20,13,433,381,90,66,Team_with_Fifa_Rank( 1--89)

Manchukuo,3,0,3,0,0,3,0,0,0,0,0,0,0,0,0,16,0,0,Team_with_Fifa_Rank( 180--269)

Croatia,329,174,69,86,68,29,37,106,40,49,71,37,18,16,573,334,124,78,Team_with_Fifa_Rank( 1--89)

Lebanon,276,75,122,79,25,47,42,50,75,37,46,15,15,16,316,424,49,41,Team_with_Fifa_Rank( 180--269)

Puerto Rico,121,23,77,21,6,30,6,17,47,15,21,4,14,3,121,275,19,45,Team_with_Fifa_Rank( 180--269)

Afghanistan,112,31,57,24,7,15,5,24,42,19,38,13,18,7,117,225,48,68,Team_with_Fifa_Rank( 90--179)

Iran,502,275,99,128,100,53,53,175,46,75,66,44,8,14,932,403,135,36,Team_with_Fifa_Rank( 1--89)

Mongolia,75,19,48,8,1,10,2,18,38,6,31,9,18,4,96,217,52,69,Team_with_Fifa_Rank( 90--179)

Tanzania,535,147,234,154,70,108,76,77,126,78,63,14,27,22,601,808,52,78,Team_with_Fifa_Rank( 90--179)

Zimbabwe,459,190,143,126,70,66,50,120,77,76,60,25,12,23,626,521,89,54,Team_with_Fifa_Rank( 90--179)

Zambia,723,331,201,191,134,92,83,197,109,108,84,33,21,30,1130,743,101,81,Team_with_Fifa_Rank( 1--89)

Iceland,457,142,230,85,75,91,43,67,139,42,78,30,33,15,546,766,107,117,Team_with_Fifa_Rank( 1--89)

Albania,342,90,181,71,39,37,26,51,144,45,58,23,26,9,318,531,65,73,Team_with_Fifa_Rank( 1--89)

Montenegro,118,41,46,31,17,15,11,24,31,20,53,17,24,12,143,155,64,73,Team_with_Fifa_Rank( 1--89)

Madagascar,225,85,92,48,34,29,16,51,63,32,57,24,16,17,294,345,73,67,Team_with_Fifa_Rank( 90--179)

Mauritius,250,68,130,52,45,35,23,23,95,29,47,9,28,10,310,427,35,87,Team_with_Fifa_Rank( 90--179)

Réunion,81,27,41,13,18,41,11,9,0,2,0,0,0,0,135,191,0,0,Team_with_Fifa_Rank( 180--269)

Zanzibar,205,41,123,41,8,58,8,33,65,33,9,4,3,2,187,434,12,12,Team_with_Fifa_Rank( 180--269)

Djibouti,88,4,77,7,1,17,1,3,60,6,23,2,18,3,60,333,13,68,Team_with_Fifa_Rank( 90--179)

Ethiopia,366,134,152,80,52,38,26,82,114,54,48,16,16,16,514,537,67,64,Team_with_Fifa_Rank( 90--179)

DR Congo,466,183,156,127,57,63,53,126,93,74,70,28,20,22,703,579,106,79,Team_with_Fifa_Rank( 90--179)

South Korea,865,455,188,222,134,85,73,321,103,149,83,47,17,19,1516,784,130,68,Team_with_Fifa_Rank( 1--89)

Vietnam,202,82,73,47,21,9,14,61,64,33,44,21,7,16,339,293,71,41,Team_with_Fifa_Rank( 90--179)

Macau,128,21,92,15,3,24,4,18,68,11,25,6,13,6,107,384,27,44,Team_with_Fifa_Rank( 180--269)

Dominican Republic,117,46,55,16,11,15,3,35,40,13,29,14,12,3,185,193,49,29,Team_with_Fifa_Rank( 90--179)

Cyprus,373,71,240,62,21,53,26,50,187,36,51,12,32,7,325,814,47,89,Team_with_Fifa_Rank( 90--179)

Sierra Leone,256,78,115,63,25,45,12,53,70,51,21,5,10,6,242,347,15,25,Team_with_Fifa_Rank( 90--179)

Nigeria,580,269,144,167,104,67,79,165,77,88,69,35,18,16,861,581,91,60,Team_with_Fifa_Rank( 90--179)

Syria,408,151,156,101,50,75,52,101,81,49,63,26,18,19,590,537,92,76,Team_with_Fifa_Rank( 1--89)

Serbia,286,127,84,75,46,43,29,81,41,46,62,28,17,17,438,307,97,75,Team_with_Fifa_Rank( 1--89)

Chinese Taipei,149,38,90,21,14,17,7,24,73,14,36,14,19,3,192,399,44,77,Team_with_Fifa_Rank( 90--179)

Ghana,604,288,156,160,122,80,79,166,76,81,60,27,14,19,981,619,87,50,Team_with_Fifa_Rank( 1--89)

New Caledonia,227,120,80,27,40,37,12,80,43,15,23,10,6,7,614,322,48,23,Team_with_Fifa_Rank( 90--179)

Vanuatu,174,56,96,22,13,29,10,43,67,12,19,8,7,4,341,387,55,28,Team_with_Fifa_Rank( 90--179)

Fiji,221,97,84,40,30,37,21,67,47,19,34,11,11,12,523,361,70,38,Team_with_Fifa_Rank( 90--179)

Burma,341,151,130,60,22,38,15,129,92,45,35,10,18,7,572,503,37,62,Team_with_Fifa_Rank( 180--269)

Pakistan,190,38,118,34,16,38,16,22,80,18,11,3,7,1,178,448,11,17,Team_with_Fifa_Rank( 180--269)

Sri Lanka,201,40,126,35,9,39,16,31,87,19,27,3,21,3,200,491,15,63,Team_with_Fifa_Rank( 180--269)

German DR,298,140,92,66,96,59,44,44,33,22,0,0,0,0,506,361,0,0,Team_with_Fifa_Rank( 180--269)

Tahiti,210,109,73,28,28,22,12,81,51,16,15,6,5,4,564,350,30,24,Team_with_Fifa_Rank( 90--179)

Gambia,216,52,99,65,23,40,24,29,59,41,31,8,10,13,200,304,26,34,Team_with_Fifa_Rank( 90--179)

Hong Kong,389,127,175,87,48,44,27,79,131,60,46,17,17,12,580,646,58,52,Team_with_Fifa_Rank( 90--179)

Singapore,556,168,280,108,68,88,42,100,192,66,55,17,27,11,731,1028,61,84,Team_with_Fifa_Rank( 90--179)

Malaysia,603,210,243,150,48,69,43,162,174,107,63,25,25,13,908,923,93,92,Team_with_Fifa_Rank( 90--179)

Guinea-Bissau,149,42,76,31,12,12,3,30,64,28,32,9,17,6,147,232,26,51,Team_with_Fifa_Rank( 180--269)

Saarland,9,1,6,2,0,4,1,1,2,1,0,0,0,0,10,26,0,0,Team_with_Fifa_Rank( 180--269)

Burundi,191,59,84,48,9,13,12,50,71,36,44,13,19,12,204,245,52,57,Team_with_Fifa_Rank( 90--179)

Kernow,11,6,3,2,6,3,2,0,0,0,1,1,0,0,30,18,5,0,Team_with_Fifa_Rank( 180--269)

Cambodia,225,48,146,31,8,32,8,40,114,23,56,16,35,5,252,586,65,126,Team_with_Fifa_Rank( 90--179)

Thailand,640,237,255,148,47,44,25,190,211,123,58,24,20,14,981,1004,84,69,Team_with_Fifa_Rank( 90--179)

Vietnam Republic,153,66,60,27,8,5,5,58,55,22,0,0,0,0,281,265,0,0,Team_with_Fifa_Rank( 180--269)

Kyrgyzstan,146,44,79,23,9,33,13,35,46,10,43,20,15,8,160,250,62,53,Team_with_Fifa_Rank( 90--179)

Moldova,245,45,141,59,21,39,32,24,102,27,61,5,40,16,193,414,27,113,Team_with_Fifa_Rank( 90--179)

North Vietnam,24,7,14,3,5,12,2,2,2,1,0,0,0,0,49,52,0,0,Team_with_Fifa_Rank( 180--269)

Togo,389,119,168,102,53,77,41,66,91,61,47,11,18,18,419,529,46,52,Team_with_Fifa_Rank( 90--179)

North Korea,340,144,105,91,31,35,30,113,70,61,54,22,19,13,541,379,73,83,Team_with_Fifa_Rank( 90--179)

Sudan,402,135,166,101,37,49,33,98,117,68,39,11,16,12,455,538,35,40,Team_with_Fifa_Rank( 90--179)

Malta,408,51,286,71,31,83,30,20,203,41,57,7,38,12,257,932,35,115,Team_with_Fifa_Rank( 90--179)

Tunisia,585,246,170,169,114,92,81,132,78,88,72,31,20,21,843,621,112,79,Team_with_Fifa_Rank( 1--89)

Libya,339,123,130,86,69,66,40,54,64,46,51,14,24,13,429,412,54,65,Team_with_Fifa_Rank( 90--179)

Malawi,568,200,203,165,103,94,86,97,109,79,56,17,18,21,680,715,42,48,Team_with_Fifa_Rank( 90--179)

Morocco,539,249,130,160,103,59,60,146,71,100,74,40,15,19,755,452,112,43,Team_with_Fifa_Rank( 1--89)

Benin,262,60,136,66,25,67,33,35,69,33,38,14,9,15,269,476,44,37,Team_with_Fifa_Rank( 1--89)

Cape Verde,170,61,71,38,13,12,10,48,59,28,34,14,13,7,178,199,41,37,Team_with_Fifa_Rank( 1--89)

Cameroon,538,232,137,169,63,64,73,169,73,96,74,26,16,32,739,558,75,66,Team_with_Fifa_Rank( 1--89)

Central African Republic,98,20,56,22,5,18,4,15,38,18,25,8,10,7,104,192,29,42,Team_with_Fifa_Rank( 90--179)

Mali,502,200,173,129,78,92,52,122,81,77,56,21,14,21,639,577,75,54,Team_with_Fifa_Rank( 1--89)

Gabon,362,126,131,105,49,70,57,77,61,48,51,13,20,18,419,409,47,56,Team_with_Fifa_Rank( 1--89)

Burkina Faso,392,126,157,109,61,74,56,65,83,53,63,23,18,22,453,532,69,60,Team_with_Fifa_Rank( 1--89)

Ivory Coast,569,283,142,144,115,66,61,168,76,83,77,36,18,23,911,589,99,62,Team_with_Fifa_Rank( 1--89)

Congo,378,129,151,98,49,61,39,80,90,59,47,12,18,17,476,517,53,65,Team_with_Fifa_Rank( 180--269)

Iraq,553,254,138,161,87,60,75,167,78,86,74,29,18,27,872,517,93,74,Team_with_Fifa_Rank( 1--89)

Saint Vincent and the Grenadines,148,65,44,39,12,9,10,53,35,29,23,9,9,5,249,201,29,36,Team_with_Fifa_Rank( 90--179)

Senegal,532,233,155,144,87,81,59,146,74,85,66,39,10,17,692,510,101,43,Team_with_Fifa_Rank( 1--89)

Guinea,469,171,163,135,55,71,52,116,92,83,56,18,23,15,635,580,72,80,Team_with_Fifa_Rank( 90--179)

Algeria,509,216,152,141,89,71,64,127,81,77,62,32,16,14,718,526,124,65,Team_with_Fifa_Rank( 1--89)

Kuwait,568,237,176,155,78,70,83,159,106,72,39,11,18,10,878,615,54,47,Team_with_Fifa_Rank( 90--179)

Jordan,401,141,141,119,55,71,69,86,70,50,76,30,22,24,483,435,106,66,Team_with_Fifa_Rank( 90--179)

Papua New Guinea,116,35,60,21,1,15,2,34,45,19,15,5,6,4,280,242,36,25,Team_with_Fifa_Rank( 90--179)

Solomon Islands,170,72,68,30,19,13,10,53,55,20,29,12,12,5,383,347,72,43,Team_with_Fifa_Rank( 90--179)

Liberia,247,68,122,57,22,36,24,46,86,33,29,9,15,5,220,344,27,38,Team_with_Fifa_Rank( 90--179)

Somalia,107,10,85,12,1,8,1,9,77,11,11,1,10,0,56,297,5,29,Team_with_Fifa_Rank( 180--269)

Laos,163,31,106,26,4,19,4,27,87,22,43,8,27,8,169,515,42,111,Team_with_Fifa_Rank( 90--179)

Saudi Arabia,628,301,185,142,108,90,62,193,95,80,71,34,24,13,998,667,124,84,Team_with_Fifa_Rank( 1--89)

Chad,118,25,65,28,6,14,8,19,51,20,20,4,14,2,106,206,13,37,Team_with_Fifa_Rank( 90--179)

Bermuda,154,55,73,26,20,39,14,35,34,12,26,11,13,2,262,249,49,46,Team_with_Fifa_Rank( 90--179)

Niger,209,49,107,53,20,39,32,29,68,21,37,11,17,9,193,348,34,56,Team_with_Fifa_Rank( 180--269)

Bahrain,496,168,186,142,60,58,49,108,128,93,69,28,20,21,606,628,90,63,Team_with_Fifa_Rank( 90--179)

Palestine,188,51,85,52,20,32,24,31,53,28,46,15,16,15,257,283,72,54,Team_with_Fifa_Rank( 90--179)

Yemen,226,45,138,43,14,39,13,31,99,30,39,7,23,9,215,513,22,69,Team_with_Fifa_Rank( 90--179)

Wallis Islands and Futuna,24,5,19,0,0,0,0,5,19,0,0,0,0,0,23,109,0,0,Team_with_Fifa_Rank( 180--269)

Corsica,9,4,1,4,4,1,4,0,0,0,3,1,0,2,10,5,3,2,Team_with_Fifa_Rank( 180--269)

Mauritania,215,39,120,56,12,35,23,27,85,33,53,17,23,13,158,335,47,63,Team_with_Fifa_Rank( 90--179)

Western Australia,29,9,17,3,0,0,0,9,17,3,0,0,0,0,55,69,0,0,Team_with_Fifa_Rank( 180--269)

Eswatini,232,46,118,68,22,58,33,24,60,35,47,10,19,18,191,396,47,70,Team_with_Fifa_Rank( 180--269)

Botswana,281,75,122,84,42,50,46,33,72,38,54,16,25,13,229,356,52,61,Team_with_Fifa_Rank( 90--179)

Qatar,540,224,188,128,77,73,50,147,115,78,85,44,29,12,775,634,154,91,Team_with_Fifa_Rank( 1--89)

Lesotho,250,45,125,80,18,56,37,27,69,43,50,10,20,20,203,393,45,65,Team_with_Fifa_Rank( 90--179)

Bahamas,38,11,21,6,1,4,0,10,17,6,12,4,6,2,48,116,17,29,Team_with_Fifa_Rank( 180--269)

Brunei,73,10,58,5,1,6,0,9,52,5,16,4,11,1,55,255,18,42,Team_with_Fifa_Rank( 90--179)

Cook Islands,43,9,30,4,1,0,2,8,30,2,3,2,1,0,38,231,4,2,Team_with_Fifa_Rank( 180--269)

Yemen DPR,24,5,16,3,5,11,1,0,5,2,0,0,0,0,25,68,0,0,Team_with_Fifa_Rank( 180--269)

United Arab Emirates,527,212,185,130,73,68,58,139,117,72,72,35,22,15,750,660,125,71,Team_with_Fifa_Rank( 1--89)

Faroe Islands,235,43,165,27,17,36,7,26,129,20,47,10,27,10,194,570,36,91,Team_with_Fifa_Rank( 90--179)

Nepal,182,39,112,31,13,23,10,26,89,21,38,8,18,12,149,433,28,53,Team_with_Fifa_Rank( 90--179)

Antigua and Barbuda,198,63,96,39,21,26,14,42,70,25,24,11,11,2,279,351,36,50,Team_with_Fifa_Rank( 90--179)

Bangladesh,213,51,116,46,14,14,15,37,102,31,43,11,22,10,185,426,34,85,Team_with_Fifa_Rank( 90--179)

Seychelles,113,13,82,18,8,16,5,5,66,13,36,1,27,8,76,245,16,85,Team_with_Fifa_Rank( 180--269)

Oman,453,168,171,114,83,58,56,85,113,58,66,31,18,17,585,566,97,67,Team_with_Fifa_Rank( 1--89)

Equatorial Guinea,132,30,73,29,10,15,12,20,58,17,43,10,22,11,110,210,37,54,Team_with_Fifa_Rank( 90--179)

Mozambique,307,99,132,76,37,49,28,62,83,48,45,17,19,9,323,394,48,57,Team_with_Fifa_Rank( 90--179)

Guam,99,23,67,9,8,6,3,15,61,6,23,4,16,3,122,478,19,50,Team_with_Fifa_Rank( 180--269)

Angola,355,123,109,123,39,41,52,84,68,71,57,19,22,16,405,374,57,62,Team_with_Fifa_Rank( 90--179)

São Tomé and Príncipe,48,8,35,5,0,7,3,8,28,2,19,4,15,0,37,116,14,44,Team_with_Fifa_Rank( 180--269)

Rwanda,246,83,100,63,17,25,25,66,75,38,48,17,19,12,264,295,53,47,Team_with_Fifa_Rank( 90--179)

Northern Cyprus,34,20,7,7,1,4,0,19,3,7,16,9,1,6,98,31,41,12,Team_with_Fifa_Rank( 180--269)

Armenia,219,57,117,45,19,31,14,38,86,31,52,19,23,10,227,374,80,90,Team_with_Fifa_Rank( 90--179)

Georgia,250,74,121,55,34,43,22,40,78,33,59,18,23,18,289,353,73,71,Team_with_Fifa_Rank( 90--179)

Azerbaijan,256,48,139,69,32,44,39,16,95,30,56,12,27,17,186,421,49,80,Team_with_Fifa_Rank( 90--179)

Kazakhstan,207,49,108,50,23,25,22,26,83,28,53,11,27,15,214,340,49,81,Team_with_Fifa_Rank( 90--179)

Tonga,56,14,36,6,0,6,1,14,30,5,11,0,11,0,67,207,4,58,Team_with_Fifa_Rank( 180--269)

Kiribati,11,0,10,1,0,0,0,0,10,1,0,0,0,0,7,126,0,0,Team_with_Fifa_Rank( 180--269)

Tuvalu,34,5,25,4,2,4,0,3,21,4,14,1,12,1,35,197,10,93,Team_with_Fifa_Rank( 180--269)

Samoa,51,16,31,4,0,3,1,16,28,3,9,3,6,0,71,169,8,39,Team_with_Fifa_Rank( 180--269)

Greenland,73,24,40,9,1,6,1,23,34,8,9,5,1,3,140,147,15,13,Team_with_Fifa_Rank( 180--269)

Liechtenstein,207,17,163,27,7,48,8,10,115,19,51,5,38,8,93,581,23,139,Team_with_Fifa_Rank( 90--179)

Bhutan,81,8,68,5,2,11,0,6,57,5,31,4,26,1,48,323,16,134,Team_with_Fifa_Rank( 90--179)

Niue,2,0,2,0,0,0,0,0,2,0,0,0,0,0,0,33,0,0,Team_with_Fifa_Rank( 180--269)

American Samoa,48,5,41,2,0,1,0,5,40,2,9,3,5,1,36,306,15,39,Team_with_Fifa_Rank( 180--269)

Belize,81,19,50,12,8,5,5,11,45,7,23,9,12,2,88,164,29,33,Team_with_Fifa_Rank( 90--179)

Cayman Islands,93,19,60,14,2,15,1,17,45,13,13,4,8,1,92,237,8,37,Team_with_Fifa_Rank( 180--269)

Anguilla,63,3,55,5,1,11,2,2,44,3,16,0,14,2,37,261,5,70,Team_with_Fifa_Rank( 180--269)

British Virgin Islands,93,16,63,14,9,14,5,7,49,9,14,0,12,2,79,296,8,45,Team_with_Fifa_Rank( 180--269)

Palau,2,0,2,0,0,2,0,0,0,0,0,0,0,0,4,21,0,0,Team_with_Fifa_Rank( 180--269)

Sint Maarten,34,10,19,5,1,1,2,9,18,3,11,2,8,1,44,92,14,48,Team_with_Fifa_Rank( 180--269)

Namibia,232,63,107,62,10,30,21,53,77,41,58,24,22,12,238,334,62,58,Team_with_Fifa_Rank( 90--179)

Ynys Môn,61,32,18,11,1,0,0,31,18,11,14,9,4,1,112,89,31,22,Team_with_Fifa_Rank( 180--269)

Shetland,51,18,26,7,0,0,0,18,26,7,13,4,8,1,85,102,25,27,Team_with_Fifa_Rank( 180--269)

Åland Islands,46,21,19,6,0,0,0,21,19,6,8,3,2,3,73,75,8,8,Team_with_Fifa_Rank( 180--269)

Saint Martin,44,14,27,3,6,3,0,8,24,3,11,4,7,0,51,127,14,31,Team_with_Fifa_Rank( 180--269)

San Marino,172,1,165,6,1,15,1,0,150,5,45,0,43,2,24,730,4,184,Team_with_Fifa_Rank( 180--269)

Montserrat,42,9,27,6,0,1,0,9,26,6,14,5,4,5,44,143,16,15,Team_with_Fifa_Rank( 90--179)

Slovenia,258,91,104,63,26,37,20,65,67,43,54,19,20,15,315,309,66,49,Team_with_Fifa_Rank( 1--89)

Jersey,82,55,16,11,12,7,6,43,9,5,12,9,2,1,181,80,38,9,Team_with_Fifa_Rank( 180--269)

Guernsey,77,37,23,17,4,12,7,33,11,10,14,10,2,2,169,102,41,14,Team_with_Fifa_Rank( 180--269)

Isle of Wight,44,23,14,7,0,0,0,23,14,7,4,2,1,1,106,56,7,3,Team_with_Fifa_Rank( 180--269)

Turkmenistan,138,52,63,23,11,25,7,41,38,16,29,10,15,4,214,206,32,48,Team_with_Fifa_Rank( 90--179)

Tajikistan,150,59,64,27,14,28,12,45,36,15,45,14,21,10,227,218,58,66,Team_with_Fifa_Rank( 90--179)

Uzbekistan,281,122,101,58,37,52,28,85,49,30,63,30,24,9,458,333,84,62,Team_with_Fifa_Rank( 1--89)

Eritrea,72,11,45,16,2,5,2,9,40,14,4,0,4,0,48,126,2,9,Team_with_Fifa_Rank( 180--269)

Czech Republic,308,166,82,60,53,32,26,113,50,34,64,30,26,8,551,304,99,82,Team_with_Fifa_Rank( 1--89)

Gibraltar,107,32,64,11,4,10,4,28,54,7,50,6,39,5,146,256,21,170,Team_with_Fifa_Rank( 180--269)

Isle of Man,49,29,16,4,0,0,0,29,16,4,14,12,2,0,156,75,65,15,Team_with_Fifa_Rank( 180--269)

North Macedonia,246,73,110,63,36,35,30,37,75,33,53,20,21,12,288,332,75,63,Team_with_Fifa_Rank( 1--89)

Bosnia and Herzegovina,230,88,90,52,23,33,23,65,57,29,57,23,19,15,330,310,87,67,Team_with_Fifa_Rank( 1--89)

Canary Islands,4,3,1,0,3,1,0,0,0,0,0,0,0,0,11,3,0,0,Team_with_Fifa_Rank( 180--269)

Maldives,159,47,86,26,6,22,9,41,64,17,39,13,24,2,220,352,56,84,Team_with_Fifa_Rank( 90--179)

Andorra,175,6,148,21,3,33,9,3,115,12,52,3,38,11,48,454,13,105,Team_with_Fifa_Rank( 90--179)

Frøya,30,6,22,2,0,0,0,6,22,2,4,0,3,1,53,117,7,17,Team_with_Fifa_Rank( 180--269)

Hitra,19,4,14,1,0,0,0,4,14,1,11,3,7,1,24,82,18,34,Team_with_Fifa_Rank( 180--269)

U.S. Virgin Islands,56,7,43,6,1,7,3,6,36,3,19,4,15,0,29,243,10,54,Team_with_Fifa_Rank( 180--269)

Northern Mariana Islands,24,2,20,2,1,4,1,1,16,1,5,0,4,1,18,107,2,25,Team_with_Fifa_Rank( 180--269)

Turks and Caicos Islands,29,6,21,2,0,3,0,6,18,2,12,3,8,1,24,120,14,62,Team_with_Fifa_Rank( 180--269)

Micronesia,7,1,6,0,1,2,0,0,4,0,0,0,0,0,8,59,0,0,Team_with_Fifa_Rank( 180--269)

Gotland,30,11,15,4,0,0,0,11,15,4,8,2,6,0,81,57,22,16,Team_with_Fifa_Rank( 180--269)

Saare County,35,5,25,5,0,0,0,5,25,5,8,2,4,2,41,89,14,17,Team_with_Fifa_Rank( 180--269)

Rhodes,18,11,5,2,0,0,0,11,5,2,0,0,0,0,29,19,0,0,Team_with_Fifa_Rank( 180--269)

Tibet,13,0,12,1,0,3,0,0,9,1,5,0,4,1,6,55,4,20,Team_with_Fifa_Rank( 180--269)

Orkney,21,5,16,0,0,0,0,5,16,0,8,3,5,0,23,72,10,16,Team_with_Fifa_Rank( 180--269)

Falkland Islands,29,6,23,0,0,0,0,6,23,0,8,1,7,0,28,108,6,24,Team_with_Fifa_Rank( 180--269)

Monaco,12,5,4,3,4,2,3,1,2,0,1,0,0,1,15,52,0,0,Team_with_Fifa_Rank( 180--269)

Mayotte,18,3,10,5,0,3,4,3,7,1,0,0,0,0,29,37,0,0,Team_with_Fifa_Rank( 180--269)

Vatican City,6,0,4,2,0,4,2,0,0,0,1,0,0,1,2,15,0,0,Team_with_Fifa_Rank( 180--269)

East Timor,51,4,44,3,1,5,0,3,39,3,22,1,20,1,42,173,8,76,Team_with_Fifa_Rank( 180--269)

Alderney,19,3,16,0,0,0,0,3,16,0,11,2,9,0,15,75,11,44,Team_with_Fifa_Rank( 180--269)

Sark,4,0,4,0,0,0,0,0,4,0,0,0,0,0,0,70,0,0,Team_with_Fifa_Rank( 180--269)

Western Isles,28,11,14,3,0,0,0,11,14,3,12,4,7,1,44,70,14,41,Team_with_Fifa_Rank( 180--269)

Kosovo,49,18,21,10,10,4,3,8,17,7,44,16,19,9,70,74,60,64,Team_with_Fifa_Rank( 90--179)

Republic of St. Pauli,4,1,2,1,0,0,0,1,2,1,0,0,0,0,10,5,0,0,Team_with_Fifa_Rank( 180--269)
